111111111111111
1P00100C00000E1
1C1010111010101
1010001000101C1
101111101110101
1000C0001000001
111111111111111
