1111111111111111111111111111111111111111
1P1000000010000C0000001000000C0000000011
1011101011101110111110111011101111111111
1000101010001000100010001000101000000011
1110101110111011101011101111101011111011
1C00100010001000001000101000100010001011
1011101010111111111110101010111110101011
1010001000100000100C00100010000010100011
1010111111101110101111111111111010111011
1000100010001000100010000000100000100011
1110101110111110101111111110101111111011
1000101000100000100010001010100000000011
1011101010111111111010101010111111111111
1000001010000000000010100010000000100011
1011111011111111111110111011111110101011
10100000C0000000000000100000001010001Z11
1011111111111111111111111111101011100C11
10100010000010001000000000100000000Z1C11
1010101011101010101111111011111111111C11
1000100010000010001000000000000000CCCE11
1111111111111111111111111111111111111111